0000000000000100000000000000
0111111111111111111111111110
0000000020000000000200000000
0000000020000000000200000000
0111111111111111111111111110
0000200000000000000000020000
0000200000000000000000020000
0111111111111111111111111110
0000000000000200000000000000
0000000000000200000000000000
0111111111111111111111111110
0000000002000000020000000000
0000000002000000020000000000
0111111111111111111111111110
0000000000200002000000000000
0000000000200002000000000000
0111111111111111111111111110
0000000000000000000000000000